**********
*S.......*
*.******.*
*.*....*.*
*.*.*.**.*
*...*..***
*.***..*E*
*.*.*.**.*
*.*......*
**********
